NO ./textures/north.xpm
SO ./textures/south.xpm
WE ./textures/west.xpm
EA ./textures/east.xpm


F 90,90,90
C 0,0,0


11111111111
 10000000001
111110011111
 111110011111
1000000000011111111
1000000000000000001
100S000000011111111
1000011000111
111111111111
