NO ./textures/north.xpm
SO ./textures/south.xpm
WE ./textures/west.xpm
EA ./textures/east.xpm

F 220,111,119
C 0,0,0

1111111111111
1000000S00001
1000011*00001
1000010100001
1111111111111
