NO ./textures/north.xpm
SO ./textures/south.xpm
WE ./textures/west.xpm
EA ./textures/east.xpm

F 90,90,90
C 0,0,0







111111111
1000000001
111110011111
111110011111
N00000000001
10000000001
1000000000111
10000110011
1111111111
