NO ./textures/north.xpm
SO ./textures/south.xpm
WE ./textures/west.xpm
EA ./textures/east.xpm

F 220,111,119
C 0,0,0

1111111111111
1000000000001
100000S000001
1000000000001
1111111111111