NO ./textures/north.xpm
SO ./textures/south.xpm
WE ./textures/west.xpm
EA ./textures/east.xpm

F 90,90,90
C 0,0,0
 
 11111111111
1000000000001
1000000000001
1000000000001
1111111111111