NO ./textures/north.xpm
SO ./textures/south.xpm
WE ./textures/west.xpm
EA ./textures/east.xpm

F 90,90,90
C 0,0,0

111111111111
100000000001
1000000000001
10000000000S1
 111111111111
