NO ./textures/north.xpm
SO ./textures/south.xpm
WE ./textures/west.xpm
EA ./textures/east.xpm

F 90,90,90
C 0,0,0


11111111111111111111111
100000000000000000000001
 10000000000S0000000001
  10000000000000000001
   100000000000000001
    1000000000000001
     10000000000001
      100000000001
       1000000001
        10000001
         100001
          1001
           11
